19,20,19,20,1,2,1,2,1,2,1,2,1,2,1,2,1,2,1,2,1,2,1,2,1,2,1,2,1,2,1,2,1,2,1,2,1,2,1,2,1,2,1,2,1,2,1,2,1,2,1,2,1,2,1,2,1,2,1,2,1,2,1,2,1,2,1,2,1,2,1,2,1,2,1,2,1,2,1,2,1,2,1,2,1,2,1,2,1,2,1,2,1,2,1,2,1,2,1,2,
0,0,0,0,11,10,9,10,9,10,9,10,9,10,9,10,9,10,9,10,9,10,9,10,9,10,9,10,9,10,9,10,9,10,9,10,9,10,9,10,9,10,9,10,9,10,9,10,9,10,9,10,9,10,9,10,9,10,9,10,9,10,9,10,9,10,9,10,9,10,9,10,9,10,9,10,9,10,9,10,9,10,9,10,9,10,9,10,9,10,9,10,9,10,9,10,9,10,9,10,
0,0,0,0,11,2,1,2,1,2,1,2,1,2,1,2,1,2,1,2,1,2,1,2,1,2,1,2,1,2,1,2,1,2,1,2,1,2,1,2,1,2,1,2,1,2,1,2,1,2,1,2,1,2,1,2,1,17,18,17,18,17,17,17,17,17,17,17,17,17,18,17,18,19,17,18,19,20,17,18,17,18,19,20,17,18,19,20,17,18,17,18,19,20,17,18,17,18,19,20,
0,0,0,0,11,10,9,10,9,10,9,10,9,10,9,10,9,10,17,17,18,19,17,18,19,20,17,18,19,20,9,10,9,10,9,10,9,10,9,10,9,10,9,10,9,10,9,10,9,10,9,10,9,10,9,10,12,0,0,0,0,0,0,0,0,0,0,0,0,0,0,0,0,0,0,0,0,0,0,0,0,0,0,0,0,0,0,0,0,0,0,0,0,0,0,0,0,0,0,0,
0,0,0,0,11,2,1,2,1,2,1,2,1,2,1,2,1,12,0,0,0,0,0,0,0,0,0,0,0,0,11,2,1,2,1,2,1,2,1,2,1,2,1,2,1,2,1,2,1,2,1,2,1,2,1,2,12,0,0,0,0,0,0,0,0,0,0,0,0,0,0,0,0,0,0,0,0,0,0,0,0,0,0,0,0,0,0,0,0,0,0,0,0,0,0,0,0,0,0,0,
0,0,0,0,11,10,9,10,9,10,9,10,9,10,9,10,9,12,0,0,0,0,0,0,0,0,0,0,0,0,11,10,9,10,9,10,9,10,9,10,9,10,9,10,9,10,9,10,9,10,9,10,9,17,18,19,22,0,0,0,0,0,0,0,0,0,0,0,0,0,0,0,0,0,0,0,0,0,0,0,0,0,0,0,0,0,0,0,0,0,0,0,0,0,0,0,0,0,0,0,
0,0,0,0,21,17,18,17,18,19,20,19,20,17,18,19,20,22,0,0,0,0,0,0,0,0,0,0,0,0,21,17,18,19,20,17,18,19,20,2,1,2,1,2,1,2,1,2,1,2,17,18,22,0,0,0,0,0,0,0,0,0,0,0,0,0,0,58,0,0,0,0,0,0,0,0,0,0,0,0,0,0,0,0,0,0,0,0,0,0,0,0,0,0,0,0,0,0,0,0,
0,0,0,0,0,0,0,0,0,0,0,0,0,0,0,0,0,0,0,0,0,0,0,0,0,0,0,0,0,0,0,0,0,0,0,0,0,0,0,11,9,10,9,10,9,10,9,17,18,22,0,0,0,0,0,0,0,0,0,0,0,3,5,6,7,8,5,6,7,8,4,0,0,0,0,0,0,0,0,0,0,0,0,0,0,0,0,0,0,0,0,0,0,0,0,0,0,0,0,0,
0,0,0,0,0,0,0,0,0,0,0,0,0,0,0,0,0,0,0,0,0,0,0,0,0,0,0,0,0,0,0,0,0,0,0,0,0,0,0,21,18,19,17,18,19,20,22,0,0,0,0,0,0,0,0,0,0,0,0,0,3,14,1,2,1,2,1,2,1,2,15,4,0,0,0,0,0,0,0,0,0,0,0,0,0,0,0,0,0,0,0,0,0,0,0,0,0,0,0,0,
0,0,0,0,0,0,0,0,0,0,0,0,0,0,0,0,0,0,0,0,0,0,0,0,0,0,0,0,0,0,0,0,0,0,0,0,0,0,0,0,0,0,0,0,0,0,0,0,0,0,0,0,0,0,0,0,0,0,0,3,1,1,2,10,9,1,10,10,1,10,2,15,4,0,0,0,0,0,0,0,0,0,0,0,0,0,0,0,0,0,0,0,0,0,0,0,0,0,0,0,
0,0,0,0,0,0,0,0,0,0,0,0,0,0,0,0,0,0,0,26,0,0,0,0,0,0,57,0,0,26,0,0,0,0,0,0,0,0,0,0,0,0,0,0,0,0,0,0,0,0,0,30,0,0,0,57,0,0,3,14,1,2,1,10,1,1,9,10,2,9,10,2,15,4,0,0,0,0,0,0,0,57,0,0,0,0,0,0,0,57,0,0,0,0,0,63,0,0,62,0,
5,6,7,8,5,6,13,5,6,7,8,16,16,7,8,8,5,6,7,8,13,5,6,7,8,6,7,8,5,6,5,6,7,8,6,7,8,7,8,7,8,6,7,8,5,6,7,8,5,6,7,8,5,6,7,8,5,13,14,10,9,1,9,10,1,9,10,9,1,9,9,1,2,15,5,6,5,6,7,8,7,8,5,5,6,7,8,6,7,8,5,6,7,8,5,6,5,6,7,8,